{
  "width": 30,
  "height": 30,
  "tiles": [
    2,2,2,2,2,2,2,0,2,2,2,2,2,2,2,2,2,2,2,2,2,0,2,2,2,2,2,2,2,2,
    2,2,2,2,2,2,2,1,2,2,2,2,2,2,2,2,2,2,2,2,2,1,2,2,2,2,2,2,2,2,
    2,2,2,2,2,2,2,4,2,2,2,2,2,2,2,2,2,2,2,2,2,4,2,2,2,2,2,2,2,2,
    2,2,2,2,2,2,2,5,2,2,2,2,2,2,2,2,2,2,2,2,2,5,2,2,2,2,2,2,2,2,
    2,2,2,2,2,2,2,13,2,2,2,2,2,2,2,2,2,2,2,2,2,13,2,2,2,2,2,2,2,2,
    0,1,4,5,13,0,1,4,5,13,0,1,4,5,13,0,1,4,5,13,0,1,4,5,13,0,1,4,5,13,
    2,2,2,2,2,2,2,0,2,2,2,2,2,2,2,2,2,2,2,2,2,0,2,2,2,2,2,2,2,2,
    2,2,2,2,2,2,2,1,2,2,2,2,2,2,2,2,2,2,2,2,2,1,2,2,2,2,2,2,2,2,
    2,2,2,2,2,2,2,4,2,2,2,2,2,2,2,2,2,2,2,2,2,4,2,2,2,2,2,2,2,2,
    2,2,2,2,2,2,2,5,2,2,2,2,2,2,2,2,2,2,2,2,2,5,2,2,2,2,2,2,2,2,
    2,2,2,2,2,2,2,13,2,2,2,2,2,2,2,2,2,2,2,2,2,13,2,2,2,2,2,2,2,2,
    0,1,4,5,13,0,1,4,5,13,0,1,4,5,13,0,1,4,5,13,0,1,4,5,13,0,1,4,5,13,
    2,2,2,2,2,2,2,0,2,2,2,2,2,2,2,2,2,2,2,2,2,0,2,2,2,2,2,2,2,2,
    2,2,2,2,2,2,2,1,2,2,2,2,2,2,2,2,2,2,2,2,2,1,2,2,2,2,2,2,2,2,
    2,2,2,2,2,2,2,4,2,2,2,2,2,2,2,2,2,2,2,2,2,4,2,2,2,2,2,2,2,2,
    2,2,2,2,2,2,2,5,2,2,2,2,2,2,2,2,2,2,2,2,2,5,2,2,2,2,2,2,2,2,
    2,2,2,2,2,2,2,13,2,2,2,2,2,2,2,2,2,2,2,2,2,13,2,2,2,2,2,2,2,2,
    0,1,4,5,13,0,1,4,5,13,0,1,4,5,13,0,1,4,5,13,0,1,4,5,13,0,1,4,5,13,
    2,2,2,2,2,2,2,0,2,2,2,2,2,2,2,2,2,2,2,2,2,0,2,2,2,2,2,2,2,2,
    2,2,2,2,2,2,2,1,2,2,2,2,2,2,2,2,2,2,2,2,2,1,2,2,2,2,2,2,2,2,
    2,2,2,2,2,2,2,4,2,2,2,2,2,2,2,2,2,2,2,2,2,4,2,2,2,2,2,2,2,2,
    2,2,2,2,2,2,2,5,2,2,2,2,2,2,2,2,2,2,2,2,2,5,2,2,2,2,2,2,2,2,
    2,2,2,2,2,2,2,13,2,2,2,2,2,2,2,2,2,2,2,2,2,13,2,2,2,2,2,2,2,2,
    0,1,4,5,13,0,1,4,5,13,0,1,4,5,13,0,1,4,5,13,0,1,4,5,13,0,1,4,5,13,
    2,2,2,2,2,2,2,0,2,2,2,2,2,2,2,2,2,2,2,2,2,0,2,2,2,2,2,2,2,2,
    2,2,2,2,2,2,2,1,2,2,2,2,2,2,2,2,2,2,2,2,2,1,2,2,2,2,2,2,2,2,
    2,2,2,2,2,2,2,4,2,2,2,2,2,2,2,2,2,2,2,2,2,4,2,2,2,2,2,2,2,2,
    2,2,2,2,2,2,2,5,2,2,2,2,2,2,2,2,2,2,2,2,2,5,2,2,2,2,2,2,2,2,
    2,2,2,2,2,2,2,13,2,2,2,2,2,2,2,2,2,2,2,2,2,13,2,2,2,2,2,2,2,2,
    2,2,2,2,2,2,2,2,2,2,2,0,1,4,5,13,2,2,2,2,2,2,2,2,2,0,1,4,5,13
  ]
}